-19
21
-11
11
11111111111111111111111111111111111111111
00000000000000000000000000000000000000001
00000000000000000000000000000000000000001
00000000000000000000000000000000000000001
00000000000000000000000000000000000000001
00000000000000000000000000000000000000001
00000000000000000000000000000000000000001
00000000000000000000000000000000000000001
00000000000000000000000000000000000000001
00000000000000000000000000000000000000001
00000000000000100000000000000000000000001
00000000100000000000000000011111000000001
00000000000000000000000000011111000000001
00000000000000000011000000011111000000001
00000000000000000000000000011111000000001
00000000000000000000000000011111000000001
00000000001000000000000000000000000000001
00000000000000000000000000000000000000001
00000000000000000000000000000000000000001
00000000000000000000000000000000000000001
00000000000000000000000000000000000000001
00000000000000000000000000000000000000001
00000000000000000000000000000000000000001
