-11
6
-5
2
000000000000000000
000000100011111110
100000000011111110
000000000011111110
000000000011111110
000000000011111110
000000000011111110
001000000011111110
